2 2 2 1 2 2 2 2 3 2
2 3 2 2 2 2 2 2 2 2
9 9 9 9 5 2 2 3 2 1
2 2 2 2 4 2 2 2 2 2
3 1 2 2 8 9 9 9 9 9
2 2 3 2 2 2 2 2 3 2